Brevity: concise and exact use of words in writing or speech
Melodic: having, or producing melody (something tuneful or pretty to listen to)
Couth: cultured, refined, and well mannered
Uncouth: lacking good manners, refinement, or grace
Trite: overused and consequently of little import; lacking originality, or freshness
Nicety: a fine detail or distinction, especially one regarded as intricate and fussy
Intricate: very complicated or detailed
Stymie: prevent or hinder the progress of
Consortium: an association, typically of several business companies
Meander: wander at random
Clamour: a loud and confused noise, especially that of people shouting vehemently
Vehemently: in a forceful, passionate, or intense manner; with great feeling
Revelry: lively and noisy festivities 
Unbridled: uncontrolled; unconstrained
Hedonist: a person who believes that the pursuit of pleasure is the most important thing in life; a pleasure seeker
Ambivalent: having mixed feelings or contradictory ideas about something or someone 
Affront: an action or remark that causes outrage or offense
Lilt: A characteristic rising and falling of the voice when speaking; a pleasant gentle accent
Loquacious: tending to talk a great deal; talkative
Virtuoso: a person highly skilled in music or another artistic pursuit
Preen: (of a bird) straighten and clean its feathers with its beak (of a person) devote effort to making oneself look attractive and then admire one’s appearance
Erudite: having or showing great knowledge or learning 
Pedant: a person who is excessively concerned with minor details and rules or with displaying academic learning 
Broach: raise (a sensitive or difficult subject) for discussion
Eccentric: a person of unconventional and slightly strange views or behavior
Totalitarian: relating to a system of government that is centralized and dictatorial and requires complete subservience to the state
Utopia: an imagined place or state of things in which everything is perfect
Peculiar: strange or odd; unusual
Ominous: giving the impression that something bad or unpleasant is going to happen
Psyche: the human soul, mind, or spirit
Purport: appear or claim to be or do something, especially falsely
Hubris: excessive pride or self-confidence
Supplant: take the place of a person or a thing previously in authority or use
Bigot: a person who is obstinately or unreasonably attached to a belief, opinion or a faction, especially one who is prejudiced against or antagonistic toward a person or people on the basis of their membership of a particular group
Creed: a system of Christian or other religious belief; a faith
Aptly: in a manner that is appropriate or suitable in the circumstances
Trope: a figurative or metaphorical use of a word or expression
Virtue: behaviour showing high moral standards
Conducive: making a certain situation or outcome likely or possible
Appalling: causing shock or dismay; horrific
Proclivity: a tendency to choose or do something regularly
Intractable: hard to control or deal with
Nuisance: A person, thing, or circumstance causing inconvenience or annoyance
Masochist: A person who derives sexual gratification from their own pain or humiliation
Amicable: having a spirit of friendliness; without serious disagreement or rancor
Rancor: bitterness or resentfulness, especially when long-standing
Long-standing: having existed or continued for a long time
Thwarts: prevent (someone) from accomplishing something
Locale: a place where something happens or is set, or that has particular events associated with it
Deign: do something that one considers to be beneath one’s dignity
Burrow: a hole or tunnel dug by a small animal
Archetypal: very typical of a certain kind of person or thing
Paramour: a lover, especially the illicit partner of a married person
Prowess: skill or expertise in a particular activity or field
Truism: a statement that is obviously true and says nothing new or interesting
Juxtaposed: place or deal with close together for contrasting effect
Erroneous: wrong; incorrect
Agoraphobia: fearing or avoiding places, or situations that might cause panic and feelings of being trapped, helpless or embarrassed
Primordial: existing at or from the beginning of time
Disparaging: expressing the opinion that something is of little worth
Menopause: a point in time 12 months after a woman’s last period
Strife: angry or bitter disagreement over fundamental issues
Muster: assemble (troops), especially for inspection or in preparation for battle
Axioms: a statement or proposition which is regarded as being established, accepted, or self-evidently true
Malevolent: having or showing a wish to do evil to others
Stark: severe or bare in appearance or outline
Resentment: bitter indignation at having been treated unfairly
Bureaucracy: a system of government in which most of the important decisions are made by state officials rather than by elected representatives
Pathological: the science of the causes and effects of diseases 
Perpetrator: a person who carries out a harmful, illegal, or immoral act
Convulsion: a sudden, violent, irregular movement of a limb or of a body, caused by involuntary contraction of muscles and associated especially with brain disorders such as epilepsy, the presence of certain toxins or other agents in the blood, or fever in children
Vilify: speak or write about in an abusively disparaging manner
Subjugation: the action of bringing someone or something under domination or control
Stultify: to impair, invalidate, or make ineffective 
Congenial: pleasant because of a personality, qualities, or interests that are similar to one’s own
Seldom: not often; rarely
Inert: lacking the ability or strength to move
Contend: struggle to surmount (a difficulty or danger)
Surmount: overcome
Constituent: being a part of a whole
Proclivity: a tendency to choose or do something regularly; an inclination or predisposition toward a particular thing
Amalgamate: combine or unite to form one organization or structure
Androgynous: partly male and partly female in appearance
Amiss: not quite right; inappropriate or out of place
Assiduous: showing great care and perseverance
Contemptible: deserving hatred and contempt
Contempt: the feeling that a person or a thing is beneath consideration, worthless
Subtil: slight
Playwright: a person who writes plays
Sentiment: a view or attitude toward a situation or event; an opinion
Farce: a comic dramatic work using buffoonery and horseplay, and typically including crude characterization and ludicrously improbable situations; an absurd event
Spurn: reject with disdain or contempt
Predation: the preying of one animal on others
Well Nigh: almost
Propensity: an inclination or natural tendency to behave in a particular way
Cynicism: an inclination to believe that people are motivated purely by self-interest
Injunction: an authoritative warning or order
Cronies: a close friend or companion
Sloughed: shed or remove
Indelible: making marks that cannot be removed
Egregious: outstandingly bad; shocking
Indolent: wanting to avoid activity or exertion; lazy
Exertion: physical or mental effort
Impetus: the force or energy with which a body moves
Chasm: a deep fissure in the earth, rock, or another surface
Fissure: a long, narrow opening or line of breakage made by cracking or splitting, especially in rock or earth
Travesty: a false, absurd, or distorted representation of something
Elusive: difficult to find, catch, or achieve
Eminent: famous and respected within a particular sphere or profession
Quell: put an end to, typically by the use of force
Credo: a statement of the beliefs or aims which guide someone’s actions
Dismal: depressing
Denigrating: criticize unfairly
Illusory: based on illusion; not real
Omnipresent: widely or constantly encountered; common or widespread
Impeccable: in accordance with the highest standards of propriety; faultless
Trajectory: the path followed by a projectile flying or an object moving under the action of given forces
Stellar: relating to a star or stars
Compel: force or oblige (someone) to do something
Derision: mockery
Punitive: inflicting or intended as punishment
Triage: the preliminary assessment of patients or casualties in order to determine the urgency of their need for treatment and the nature of treatment required
Acolyte: a person assisting the celebrant in a religious service or procession
Dogmatic: inclined to lay down principles as incontrovertibly true
Cursory: hasty and therefore not thorough or detailed
Denizen: an inhabitant or occupant of a particular place
Astute: having or showing an ability to accurately assess situations or people and turn this to one’s advantage
Enmity: the state or feeling of being actively opposed or hostile to someone or something
Dawning: the beginning or first appearance of something 
Pragmatic: dealing with things sensibly and realistically in a way that is based on practical rather than theoretical considerations 
Stooge: a person who serves merely to support or assist others, particularly in doing unpleasant work
Sanction: a threatened penalty for disobeying a law or rule
Potent: having great power, influence, or effect
Anecdote: a short amusing or interesting story about a real incident or person
Klutz: a clumsy, awkward, or foolish person
Recalcitrant: having an obstinately uncooperative attitude toward authority or discipline
Deftly: in a way that is neatly, skillful and quick in movement
Ornery: bad-tempered and combative
Arbiter: a person who settles a dispute or has ultimate authority in a matter
Chastise: rebuke or reprimand severely
Perusal: the action of reading or examining something 
Ignoble: not honorable in character or purpose
Continuum: a continuous sequence in which adjacent elements are not perceptibly different from each other, although the extremes are quite distinct
Perceptibly: capable of being noticed or observed
Peril: serious and immediate danger
Culpability: responsibility for a fault or wrong; blame
Unsullied: not spoiled or made impure
Insidious: proceeding in a gradual, subtle way, but with harmful effects
Quotidian: of or occurring every day; daily
Bereft: deprived of or lacking (something)
Tether: tie with a rope or chain so as to restrict movement
Machination: a plot or scheme
Harridan: a strict or bossy old woman
Revile: criticize in an abusive or angrily insulting manner
Heed: pay attention to
Complacent: showing smug or uncritical satisfaction with oneself or one’s achievements
Expedient: convenient and practical although possibly improper or immoral
Vexed: problematic
Maxim: a short, pithy statement expressing a general truth or rule of conduct
Pithy: concise and forcefully expressive
Abeyance: a state of temporary disuse or suspension
Toil: work extremely hard or incessantly
Incessantly: constantly
Dally: act or move slowly
Sojourn: a temporary stay
Missive: a letter, especially a long or official one
Usurper: a person who takes a position of power or importance illegally, or by force
Gluttony: habitual greed or excess in eating
Privation: a state in which things that are essential for human well-being such as food and warmth are scarce or lacking
Purveyor: a person who sells or deals in particular goods
Contrived: deliberately created rather than arising naturally or spontaneously
Amenable: open and responsive to suggestion; easily persuaded or controlled
Bely: to give a false impression of
Ruckus: a disturbance
Pillory: attack or ridicule publicly 
Interminable: endless (used to exaggerate)
Surmise: suppose that something is true without having evidence to confirm it
Disconcerting: causing one to feel unsettled
Perturbed: feeling anxiety or concern
Adolescent: in the process of developing from a child into an adult
Gnaw: bite at or nibble something persistently
Nascent: just coming into existence and beginning to display signs of future potential
Stasis: a period or state of inactivity
Prudent: acting with or showing care and thought for the future
Squabble: quarrel noisily over a trivial matter
Quarrel: a heated argument or disagreement, typically about a trivial issue and between people who are on good terms
Havoc: widespread destruction
Discern: perceive or recognize (something)
Tranquill: free from disturbance; calm
Mote: a tiny piece of a substance
Colossal: extremely large
Preliminary: an action or event preceding or preparing for something fuller or more important 
Apace: swiftly; quickly
Salutary: producing good effects; beneficial
Hone: smooth and sharpen
Wit: mental sharpness and inventiveness; keen intelligence
Akin: of similar nature or character
Obsolete: no longer produced or used; out of date
Oddities: a strange or peculiar person, thing, or trait
Ostensibly: apparently, but perhaps not actually 
Staunch: loyal and committed in attitude 
Assiduous: showing great care and perseverance
Gleeful: exuberantly or triumphantly joyful
Susceptible: likely or liable to be influenced or harmed by a particular thing
Aberration: a departure from what is normal, usual, or expected, typically one that is unwelcome
Futile: incapable of producing any useful result; pointless
Perverse: showing deliberate and obstinate desire to behave in a way that is unreasonable or unacceptable, often in spite of the consequences 
Willfully: with the intention of causing harm; deliberately
Tenet: a principle or belief, especially one of the main principles of a religion or philosophy
Vice: immoral or wicked behaviour
Reciprocated: respond to (a gesture or action) by making a corresponding one
Banal: so lacking in originality as to be obvious and boring
Verboten: forbidden, especially by an authority
Gait: a person's manner of walking
Demur: raise doubts or objections or show reluctance
Deterioration: the process of becoming progressively worse
Ominous: giving the impression that something bad or unpleasant is going to happen; threatening
Inextricably: in a way that is impossible to disentangle or separate
Pseudo: not genuine
Tumultuous: making a loud, confused noise
Hearken: listen
Respite: a short period of rest or relief from something difficult or unpleasant
Erratic: not even or regular in pattern or movement; unpredictable
